1000 und 1 Nacht - Klaus Lage
500 Miles - The Proclaimers
99 Luftballons - Nena
Aber bitte mit Sahne - Udo Jürgens
All Star - Smash Mouth
Alles neu - Peter Fox
Angels - Robbie Williams
Basket Case - Green Day
Boulevard of Broken Dreams - Green Day
Brenna tuats guat - Hubert von Goisern
Britney Spears Medley - Britney Spears
Can't Fight This Feeling - REO Speedwagon
Can't Stop - Red Hot Chili Peppers
Creep - Radiohead
Dance with Somebody - Mando Diao
Dancing Queen - ABBA
Disney Medley - Seven Heaven
Don't Stop Believin' - Journey
Don't Stop Me Now - Queen
Du entschuldige i kenn di - Peter Cornelius
Ein Kompliment - Sportfreunde Stiller
Expresso & Tschianti - Josh.
Fireflies - Owl City
Fürstenfeld - S.T.S
Gimme! Gimme! Gimme! - ABBA
Grace Kelly - MIKA
Great Balls of Fire - Jerry Lee Lewis
Griechischer Wein - Udo Jürgens
Ham kummst - Seiler und Speer
Hey Jude - The Beatles
Hold the Line - Toto
Holiday - Green Day
Hollywood Hills - Sunrise Avenue
Hooked On A Feeling - Blue Swede, Björn Skifs
Hotel California - Eagles
I Will Survive - Gloria Gaynor
Irgendwie, irgendwo, irgendwann - Nena
It's My Life - Bon Jovi
Jailhouse Rock - The Blues Brothers
Jet Lag - Simple Plan
Jump - Van Halen
Just the Two of Us - Grover Washington Jr.
Levitating - Dua Lipa
Little Talks - Of Monsters and Men
Major Tom - Peter Schilling
Mamma Mia - ABBA
Mit 66 Jahren - Udo Jürgens
Money for Nothing - Dire Straits
More Than You Know - Axwell /\ Ingrosso
Narcotic - Liquido
Ohne Dich - Münchener Freiheit
Papaoutai - Stromae
Perfekte Welle - Juli
Piano Man - Billy Joel
Que Sera Sera - Doris Day
Rock Around the Clock - Bill Haley & His Comets
Rockin' All Over The World - Status Quo
Rolling in the Deep - Adele
Ruby - Kaiser Chiefs
S&M - Rihanna
Schickeria - Spider Murphy Gang
Schrei nach Liebe - Die Ärzte
Se bastasse una canzone - Eros Ramazzotti
Seven Nation Army (Walzer) - Seven Heaven
Seven Nation Army - The White Stripes
Sex on Fire - Kings of Leon
Shallow - Lady Gaga, Bradley Cooper
Shut Up and Dance - WALK THE MOON
Skandal im Sperrbezirk - Spider Murphy Gang
Skyfall - Adele
So What - P!nk
Sommer in der Stadt - Spider Murphy Gang
Sternenhimmel - Hubert Kah
Summer of '69 - Bryan Adams
Sweet Caroline - DJ Ötzi
Sweet Home Chicago - The Blues Brothers
Tage wie diese - Die Toten Hosen
The Greatest Show - The Greatest Showman
The best - Tina Turner
This Is The Life - Amy Macdonald
This Love - Maroon 5
Time Warp - Rocky Horror Picture Show
Viva La Vida - Coldplay
Vo Mello bis ge Schoppornou - Holstuonarmusicbigbandclub
Waterloo - ABBA
Westerland - Die Ärzte
Weus'd a Herz hast wia a Bergwerk - Rainhard Fendrich
What's Up? - 4 Non Blondes
Whatever It Takes - Imagine Dragons
Willst du - Alligatoah
Wonderwall - Oasis
Zruck zu dir (Hallo Klaus) - Nickerbocker & Biene
